###################
#####   ###########
#####$  ###########
#####  $###########
###  $ $ ##########
### # ## ##########
#   # ## #####  ..#
# $  $          ..#
##### ### #@##  ..#
#####     #########
###################