########
#      #
#  @   #
#  $   #
# #    #
# .    #
########