       ###########
       #         #
       #    $ $  #
###### # $ ##### #
#    ##### $  ##$#
#       $ $      #
#          ## ## #
#    ##@##### ## #
#    ####   # ## ##
#....#      # $   #
#....#      #     #
######      #######