#########
#.     .#
#       #
#  #$#  #
#  $ $  #
#  #$#  #
#   @   #
#.     .#
#########