######
#@   ###
#  #$  #
# *.$  #
# . #  #
########