 ####
 #  ###
## .$ #
# $$  #
# #. .#
#@  ###
#####