  #### 
###.@##
#  $$ #
# #$  #
#.   .#
#######