 ####
 #  ####
## * . #
# $  # #
# # $  #
#@ .####
#####