#####
#   ##
#.   ##
# #.$ #
# $$# #
## . @#
 ######