  #####
###  @#
#. *# #
#   $ #
# $. ##
######