######
#@   ##
# $$  #
# #. .#
#     #
#######