######
#    ##
#@ #* #
#   $ #
#  $..#
#######