 ######
##  . ##
#   $$@#
# #. $ #
#  .#  #
########