   ####
 ### @#
##.$$.#
#  $ ##
# # .#
# $ .#
######