   ####
   # @##
####   #
#. #$$ #
#     ##
#.  $##
##.  #
 #####