  ####
  #  #
  #  ###
### .. #
#  $#  #
#  .$$ #
#### @ #
   #####