 ######
##  . #
# * # #
# .$  #
#  #$##
## @ #
 #####