 ######
##.   ##
#  $$$.#
# # #  #
#.   @##
#######