#######
#     ##
# # #$ #
#. $*  #
#@  # .#
########