####
#@.####
#$$   #
#.$ # #
#  .  #
#######