#####
#   #
# # ###
#.*   #
#$ #  #
#@   *#
#######