#####
#   ##
# #$ ##
#. *  #
# $#  #
#.@*  #
#######