 #####
 #  .#
## #.#
#  $ ##
# # $ #
#  * @#
#######