#####
#  .####
# * $  #
#@$# # #
#   .  #
########