####
#  ####
#   *.#
#  $# #
#  .$@#
#######