#####
#   ###
# # *@##
#  *   #
###$   #
  #   .#
  ######