######
#.@* ##
#$  $ #
#   # #
#  .  #
#######