#######
#  .. ##
#@$ #  #
# #$$  #
#   #  #
#.  #  #
########