####
#  ##
#   ##
#$ $@##
#. #$ #
#  . .#
#######