######
# .$ ##
#   $.#
#$  #@#
#. .$ #
#######