 #####
##.  ##
#.$$$ #
# #  .#
#@   ##
######