  ######
### .  #
# $@#. #
#  $# ##
#  *  #
##  # #
 ##   #
  #####