#######
#     #
# .@. #
# $$  #
# .$  #
#     #
#######
