######
#    #####
#   $ $  #
###$...@ #
  #  #####
  ####