  ########
  #      #
### #### #
#  @$  # #
#  $*. # #
#  #.### #
#  #     #
##########