#####    #####
#  #######   #
# $ #####  $ #
#  $ ###  $ ##
##  $ #  $ ###
 ##  .... ###
 ### .##.####
 ####.##. ###
 ### ....  ##
### $  # $  ##
## $  ### $  #
# $  ##### $ #
#@  #######  #
#####    #####