#####
#   ##
#.$* #
# @# #
#    #
######