  #####
  ##  #
###   #
#  $  #
# .*.##
## $ #
###@ #
  ####