  #####
  #   #
  #.# #######
  # $       #
  #.# ### # #
 ##  #   $$ #
 ##.# #   ###
##      ###
#  @ ####
#   ##
#####