    ####
 ####  ##
 #  # * ##
##.$#  * ##
#   @ * * #
#   #  *  #
######    #
    ###  ##
      ####