#####
#  .#
#  $#
#   #
#.$@#
#####