########
#  #  ##
# *#$.##
# * $. #
# @    #
#   ####
########