###############
#             #
# # # # # # # #
#  $.$.$.$.$  #
# #.$.$.$.$.# #
#  $.$.$.$.$  #
# #.$.$.$.$.# #
#  $.$.@.$.$  #
# #.$.$.$.$.# #
#  $.$.$.$.$  #
# #.$.$.$.$.# #
#  $.$.$.$.$  #
# # # # # # # #
#             #
###############