      ####
     ##  #
   ### @ #
   #  $  #
   #    ##
  ### ###
### $$ #
# .....#
#   $$ #
# # #  #
#   ####
#####