  ######
 ###  ##
###   ##
#  .*$ #
#  *.$@#
##   ###
 ##  # #
  ######