   #####
   #   #
  ## .$##
####$. ####
# $ $.$$  #
# ...@... #
#  $$.$ $ #
#### .$####
  ##$. ##
   #   #
   #####