  ######
###    #
#  $.# #
#@#.$  #
# #$.###
#    #
######