  ####
  #  #
###  ###
## $*  #
#  *. @#
#   ####
#  ##
#####