###########
#  *.*.*  #
#   $+$   #
### ### ###
  #  $   #
  #  #   #
  #  #####
  ####