#####
#  @####
# #$$  #
#  $.# #
###..  #
  ##   #
   #####