##### #####
#   ###   #
# #. #  # #
#  $.$ $. #
##  $.$. ##
 ##$.@.$##
## .$.$  ##
# .$ $.$  #
# #  # .# #
#   ###   #
##### #####