####
#  ######
#       ####
# $ $   #  #####
##### ###    $ #
   #     $ #   #
   #  @  #$#####
   ##### #  .#
      #  ###.#
      #   ...#
      #####  #
          ####