  ######
###    #
#   ## #
# #$.  #
#@#.$###
# #$.##
#     #
###   #
  #####