#####
#  .#
#  $#
#.$@#
#####
