######
#    ##
#.$$. ##
# .$$. ##
## .$$. #
 ## .$$.#
  ## @  #
   ######