#################
#               #
#.$.$.######### #
#$.$.$          #
#.$.$.######### #
#$.$.$          #
#.$.$.######### #
#       $       #
# ############# #
#       @       #
#################