###### #
#   ## #
#  . #
#  $ ###
## * @ #
###$ # #
  #.#  #
# #   ##
# ######