#########
#   ##  #
#@#$    #
#  $$## ##
##    # ##
###$##.  #
  #  #. .#
  ##  .###
   #    #
   ##   #
   ######