####
# @#
#  ###
#.$$ #
#  . #
#  #####
#.$$ $ #
#  . . #
#  #####
####