    #####
 ####   #
 #   $  #
##  #$###
# * .  #
#  * #@#
##  *  #
 # . ###
 ##  #
  ####