######
#@   ##
# .$* ##
# #$.  #
#      #
########