 #####
##@  ###
#.$*$  #
# #   .#
#    ###
######