### ###
#.###.#
# #  .#
# $$  #
#  $ @#
#  #  #
#  ####
####