  #####
###  .#
# $ # #
# *$  #
# .#@ #
#    ##
#   ##
#####