   #####
#### . #
#  $   #
#   ** #
# @  ###
######