 ####
 #@ ####
##$$   #
#  $ # #
# # ...#
#   ####
#####