 ######
 # .$@##
## *$$ #
# .    #
# # #  #
#  .####
#####