#####
# ..####
# $    #
#  #$# #
# @ .$ #
########